9 7
0 3
1 1 1 E 1 1 1
1 1 1 0 1 1 1
1 0 0 0 1 0 1
1 0 1 0 1 0 0
1 1 1 0 1 1 1
1 0 0 0 0 0 1
1 0 1 1 1 0 1
1 0 1 1 0 0 1
0 0 1 1 1 1 1

1    1      1      0        1        1     1
1    1      1   CFU     1        1      1
1    0      0   CFU     1        0      1
1    0      1   CFU     1        0     0
1    1      1   CFU     1        1     1
1    0    0    CFU   CFL    CFL   1
1    0     1     1       1      CFU   1
1    0     1     1       1         1     1
0    0     1     1       1         1     1









