9 7
0 6
1 1 1 1 1 0 E
1 1 1 0 1 1 1
1 0 0 0 1 0 1
1 0 1 0 1 0 0
1 1 1 0 1 1 1
1 0 0 0 0 0 1
1 0 1 1 1 0 1
1 0 1 1 0 0 1
0 1 1 1 0 1 1